............#.................................
............#.................................
............#.................................
............#.................................
............#.................................
............##################................
.............................#................
.............................#................
.............................#................
.............................#................
...............###############................
...............#..............................
...............#..III.........................
...............###INI.........................
..................III.........................
...................#..........................
...#################..........................
...#..........................................
...#..........................................
...#####################################......
.......................................#......
.......................................#......
...#####################################......
...#..........................................
...#..........................................
...#..........................................
...#..........................................
