..............................................
..............................................
..............................................
..............................................
..............................................
..............................................
..............................................
..............................................
..............................................
..............................................
..............................................
..............................................
..................III.........................
..................INI.........................
......############III.........................
......#.......................................
......################################........
.....................................#........
.....................................#........
..................................####........
..................................#...........
..................................#...........
..................................#...........
.............######################...........
.......................#......................
.......................#......................
.......................S......................
