............#...............................
............#...............................
............#...............................
............#...............................
............#...............................
............##################..............
.............................#..............
.............................#..............
.............................#..............
.............................#..............
...............###############..............
...............#............................
...............#..NNN.......................
...............###NNN.......................
..................NNN.......................
...................#........................
...#################........................
...#........................................
...#........................................
...#####################################....
.......................................#....
.......................................#....
...#####################################....
...#........................................
...#........................................
...#........................................
...#........................................
