...............................S..............
...............................#..............
...............................#..............
.....###########################..............
.....#.....o..T.......o.......................
.....#..T........o.......T...o................
.....#.o..o..T........T.......................
.....#..........#################.............
.....#...o....o.#...............#.............
.....#.T.....T..#..###########..#.............
.....#..........#..#......o..#..#.............
.....#..o.......#..#..III....#..#.............
.....#.......o..#..#..INI.T..#..#.............
.....#..........#..###III....#..#.............
.....#..T.......#............#..#.............
.....#....T.o...##############..#.............
.....#..........................#.............
.....############################.............
TTTTTTTTTTTTTTTTTTTTTTTTTTTTTTTTTTTTTTTTTTTTTT
TTTTTTTTTTTTTTTTTTTTTTTTTTTTTTTTTTTTTTTTTTTTTT
TTTTTTTTTTTTTTTTTTTTTTTTTTTTTTTTTTTTTTTTTTTTTT
TTTTTTTTTTTTTTTTTTTTTTTTTTTTTTTTTTTTTTTTTTTTTT
TTTTTTTTTTTTTTTTTTTTTTTTTTTTTTTTTTTTTTTTTTTTTT
TTTTTTTTTTTTTTTTTTTTTTTTTTTTTTTTTTTTTTTTTTTTTT
TTTTTTTTTTTTTTTTTTTTTTTTTTTTTTTTTTTTTTTTTTTTTT
TTTTTTTTTTTTTTTTTTTTTTTTTTTTTTTTTTTTTTTTTTTTTT
TTTTTTTTTTTTTTTTTTTTTTTTTTTTTTTTTTTTTTTTTTTTTT
